M
Size: 5
Start: 1 2
9   0   9   3   3
6   9   6   8   3
9   4   1   9   0
2   0   -1  -1  9
8   3   9   7   5
