M
Size: 8
Start: 5 5
10  10  10  10  10  10  10  10
10  10  10  10  10  10  10  10
8   10  -1  -1  -1  -1  10  10
10  10  -1   9   9  -1  10  10
10  10  -1   9   9  -1  10  10
10  10  -1  -1   2   5  10  10
10  10  10  10  10  10  10  10
10  10  10  10  10  10  10  10
