M
Size: 8
Start: 5 4
10  10  10  10  10  10  10  10
10  10  10  10  10  10  10  10
10  10  -1  -1  -1  -1  10  10
10  10  -1  10  10  -1  10  10
10  10  -1  10  10  -1  10  10
10  10  -1  -1   5  -1  10   8
10  10  10  10  10  10  10  10
10  10  10  10  10  10  10  10